Initial level
8 8
++++++++
+aabbbc+
+     c+
+d    c+
+d fff +
+de    +
+ e ggg+
++++@+++