Third level
8 8
++++++++
+a ebbb+
+a e   +
+  eddd+
@   **f+
+   c f+
+   c f+
++++++++
