Third level
8 8
++++++++
+abbb f+
+a    f+
+ddd  f+
@  e **+
+  ec  +
+  ec  +
++++++++
