Initial level
8 8
++++++++
+daabbb+
+d  * c+
+d  * c+
+  fff +
+ e    +
+ e ggg+
++++@+++
